#############################################
#....................#......................#
#....................#......................#
#.......................................P...#
#.............................#.............#
#.............................#.............#
#.........#..........#........#.............#
#.........#..........#........#.............#
#.........#..........#........########......#
#.....#########......#......................#
#.........#..........#......................#
#.........#..........#......................#
#.........#..........#......................#
#....................#......................#
#...........................................#
#...........................................#
#....................#......................#
#....................#...........#..........#
#....................#...........#..........#
#....................#...........#..........#
#....................#.......#########......#
#.....#######........#...........#..........#
#...........#........#...........#..........#
#...........#........#...........#..........#
#...........#...............................#
#...........#...............................#
#...S.......................................#
#....................#......................#
#....................#......................#
#############################################