#############################################
#...........................................#
#...........................................#
#.....................#.....................#
#.....................#.....................#
#.....#################################.....#
#.....#...............#.....................#
#.....#...............#.....................#
#.....#...............#.....................#
#.....#......#........#...#########.........#
#.....#......#........#.....................#
#.....#......#..............................#
#.....#......#..............................#
#............#..............................#
#............#.......S.........#............#
#............#.................#............#
#..............................#............#
#..............................#......#.....#
#..............................#......#.....#
#.....................#........#......#.....#
#........##########...#........#......#.....#
#.....................#...............#.....#
#.....................#...............#.....#
#.....................#...............#.....#
#.....#################################.....#
#.....................#.....................#
#.....................#.....................#
#...........................................#
#...........................................#
#############################################
