.............................................
.............................................
.............................................
....................................######...
.............................#...#.......#...
.............................#...#.......#...
...#############.............#...#...........
....................#........#...#...........
....................#........#...#...........
....................#........#...######......
.......#............#........#...............
.......#........#########....#...............
.......#............#........#...............
.......#............#........##########......
.......#............#S.......................
.......#............#........................
...#...#.....................................
...#...####..................................
...#......#..................................
...#......#.......................#......#...
...#......#.......................#......#...
...####...#.......................#......#...
......#...#.......................#......#...
......#...#.......................#......#...
......#...#.......................#......#...
......#...........................#......#...
......#........###############....#...####...
.............................................
.............................................
.............................................
