#############################################
#...........................................#
#...........................................#
#...P.......................................#
#.............................#########.....#
#.....................................#.....#
#.....................................#.....#
#.....................................#.....#
#...........................................#
##########.....##################...........#
#...........................................#
#...........................................#
#...........................................#
#.....#................#..............#.....#
#.....#........#################......#.....#
#.....#................#..............#.....#
#...........................................#
#...........................................#
#...........................................#
#.........######################.....########
#...........................................#
#...........................................#
#.....#.....................................#
#.....#.....................................#
#.....#.....................................#
#.....########..............................#
#.......................................S...#
#...........................................#
#...........................................#
#############################################