#############################################
#...........................................#
#...........................................#
#................#..........................#
#.....#..........#............#....#........#
#.....#..........#............#....#........#
#.....#.......................#....#........#
#.....#.......................#....#........#
#.....########.......##########....####.....#
#............#.......#......................#
#............#.......#......P...............#
#.....#......#........................#.....#
#.....#......#........................#.....#
#.....#......#........................#.....#
#.....#......#####........#####.......#.....#
#.....#.......................#.......#.....#
#.....#.......................#.......#.....#
#.....#..............#........#.......#.....#
#....................#........#.............#
#..............S.....#........#.............#
#.....####...........#........#.............#
#........#....########........#########.....#
#........#....#.......................#.....#
#........#....#.......................#.....#
#........#....#...........#...........#.....#
#........#....#...........#...........#.....#
#.........................#.................#
#...........................................#
#...........................................#
#############################################