#############################################
#...........................................#
#...........................................#
#...........................................#
#......................#....................#
#......................#....................#
#......#################################....#
#......#...............#....................#
#......#...............#....................#
#......#...............#....................#
#......#......#........#...#########........#
#......#......#........#....................#
#......#......#.............................#
#......#......#.............................#
#.............#.............................#
#.............#.......S.........#...........#
#.............#.................#...........#
#...............................#...........#
#...............................#......#....#
#...............................#......#....#
#......................#........#......#....#
#.........##########...#........#......#....#
#......................#...............#....#
#......................#...............#....#
#......................#...............#....#
#......#################################....#
#......................#....................#
#......................#....................#
#...........................................#
#############################################
