.............................................
.............................................
.............................................
.............................................
.....................................######..
..............................#...#.......#..
..............................#...#.......#..
....#############.............#...#..........
.....................#........#...#..........
.....................#........#...#..........
.....................#........#...######.....
........#............#........#..............
........#........#########....#..............
........#............#........#..............
........#............#........##########.....
........#............#S......................
........#............#.......................
....#...#....................................
....#...####.................................
....#......#.................................
....#......#.......................#......#..
....#......#.......................#......#..
....####...#.......................#......#..
.......#...#.......................#......#..
.......#...#.......................#......#..
.......#...#.......................#......#..
.......#...........................#......#..
.......#........###############....#...####..
.............................................
.............................................
